11111111111111111111111111111111
1C0000C1000000C10000000000000001
10111101000111110000000000000001
1P1000C1000100000000000000000001
111011111101C1110000000000000001
100010C0100100C10000000000000001
10111010100000010000000000000001
100C1010101C00010000000000000001
1C000010101000C10000000000000001
10000010101000010000000000000001
10000010001000010000000000000E01
11111111111111111111111111111111