1111111111111111
1C0000C1000000C1
1011110100011111
1P1000C1000100E1
111011111101C111
100010C0100100C1
1011101010000001
100C1010101C0001
1C000010001000C1
1111111111111111